1111111111111111111
1E00C000000C0R0C001
10111101C0100000101
1R1C010R101010100C1
1010R10110101010R01
1C1001111R101C10001
101R01C11010101C001
1010010010101R11101
1010C1R0101R1010C01
1P0000000C00C000R01
1111111111111111111