111111111111111111
1E00C00000C0R0C001
101111010100000101
1R1C010R01010100C1
1010R1010101010R01
1C100111C101C10001
101R01C10101R1C001
1010C10001R1011101
1P000000C00C000R01
111111111111111111
