111111111111111
1E0C0011000C0P1
100000C00011111
1010C00000C0011
1C11000C00000C1
111111111111111