111111111111111
1E0R0C11000C0P1
100000C0R011111
101C0R0000C0011
1C11C00R000R0C1
111111111111111