111111111
1E0C000C1
100000111
1010C0001
1C11000P1
111111111