1111111111111111111111111111111111
1C0000R000C0000C00R00C00R100C00001
101C0101C01R00011000110011R001C101
101R010R10101R1C0R1E01R01100R10101
1P00C0000C00000000C0R00000C000R0C1
1111111111111111111111111111111111