1111111111111111111
1E00C000000C000C001
10111101C0100000101
101C0100101010100C1
1010010110101010001
1C10011110101C10001
101001C11010101C001
1010010010101011101
1010C10010101010C01
1P0000000C00C000001
1111111111111111111
