111111111111111111
1E00C00000C000C001
10111101C100000101
101C010011010100C1
101001011101010001
1C1001111101C10001
101001C1110101C001
1010C1001101010C01
1P0000C0000C000001
111111111111111111
