1111111111111111111111111111111111
1C000C0000C0000C00R00C00R00CR00001
10R011R1C01R0R01000C11R00C1001C101
101C01C01R1100C00R1E0110R1C0R101C1
10C10110111R1R110C1111R0C110C1R101
101R010C1C1C111C0R10C10011R0110101
1P1C000R00000C0000C00C0R0C000C00C1
1111111111111111111111111111111111